{
    "name": "Underground Sewers",
    "version": "1.0",
    "author": "QonQrete",
    "description": "Navigate the toxic sewers beneath the city",
    
    "dimensions": {
        "width": 100,
        "height": 25,
        "tile_size": 32
    },
    
    "background": "qq-background2.png",
    "music": "level2_theme.ogg",
    
    "player_spawn": {
        "x": 3,
        "y": 20
    },
    
    "tilemap": {
        "layers": [
            {
                "name": "background",
                "data": []
            },
            {
                "name": "main",
                "data": [
                    [0,0,0,0,0,0,0,0,0,0,0,0,0,0,0,0,0,0,0,0,0,0,0,0,0,0,0,0,0,0,0,0,0,0,0,0,0,0,0,0,0,0,0,0,0,0,0,0,0,0],
                    [0,0,0,0,0,0,0,0,0,0,0,0,0,0,0,0,0,0,0,0,0,0,0,0,0,0,0,0,0,0,0,0,0,0,0,0,0,0,0,0,0,0,0,0,0,0,0,0,0,0],
                    [1,1,1,1,0,0,0,0,0,0,0,0,0,0,0,0,0,0,0,0,0,0,0,0,0,0,0,0,0,0,0,0,0,0,0,0,0,0,0,0,0,0,0,0,0,0,1,1,1,1],
                    [6,6,6,1,0,0,0,0,0,0,0,0,0,0,0,0,0,0,0,0,0,0,0,0,0,0,0,0,0,0,0,0,0,0,0,0,0,0,0,0,0,0,0,0,0,0,1,6,6,6],
                    [6,6,6,1,0,0,0,0,0,0,0,0,1,1,1,1,0,0,0,0,0,0,0,0,0,0,0,0,0,0,0,0,0,0,1,1,1,1,0,0,0,0,0,0,0,0,1,6,6,6],
                    [6,6,6,1,0,0,0,0,0,0,0,0,0,0,0,0,0,0,0,0,0,0,0,0,0,0,0,0,0,0,0,0,0,0,0,0,0,0,0,0,0,0,0,0,0,0,1,6,6,6],
                    [6,6,6,1,0,0,0,0,0,0,0,0,0,0,0,0,0,0,0,0,20,21,22,0,0,0,0,0,0,0,0,0,0,0,0,0,0,0,0,0,0,0,0,0,0,0,1,6,6,6],
                    [6,6,6,1,0,0,0,0,0,0,0,0,0,0,0,0,0,0,0,0,0,0,0,0,0,0,0,0,0,0,0,0,0,0,0,0,0,0,0,0,0,0,0,0,0,0,1,6,6,6],
                    [6,6,6,1,1,1,1,1,0,0,0,0,0,0,0,0,0,0,0,0,0,0,0,0,0,0,0,0,0,0,0,0,0,0,0,0,0,0,0,0,1,1,1,1,1,1,1,6,6,6],
                    [6,6,6,6,6,6,6,1,0,0,0,0,0,0,0,0,0,0,0,0,0,0,0,0,0,0,0,0,0,0,0,0,0,0,0,0,0,0,0,0,1,6,6,6,6,6,6,6,6,6],
                    [6,6,6,6,6,6,6,1,0,0,0,0,0,0,20,21,21,22,0,0,0,0,0,0,0,0,0,0,0,0,20,21,21,22,0,0,0,0,0,0,1,6,6,6,6,6,6,6,6,6],
                    [6,6,6,6,6,6,6,1,0,0,0,0,0,0,0,0,0,0,0,0,0,0,0,0,0,0,0,0,0,0,0,0,0,0,0,0,0,0,0,0,1,6,6,6,6,6,6,6,6,6],
                    [6,6,6,6,6,6,6,1,0,0,0,0,0,0,0,0,0,0,0,0,0,0,0,0,0,0,0,0,0,0,0,0,0,0,0,0,0,0,0,0,1,6,6,6,6,6,6,6,6,6],
                    [6,6,6,6,6,6,6,1,1,1,1,1,0,0,0,0,0,0,0,0,0,0,0,0,0,0,0,0,0,0,0,0,0,0,0,0,1,1,1,1,1,6,6,6,6,6,6,6,6,6],
                    [6,6,6,6,6,6,6,6,6,6,6,1,0,0,0,0,0,0,0,0,0,0,0,0,0,0,0,0,0,0,0,0,0,0,0,0,1,6,6,6,6,6,6,6,6,6,6,6,6,6],
                    [6,6,6,6,6,6,6,6,6,6,6,1,0,0,0,0,0,0,0,0,0,0,0,0,0,0,0,0,0,0,0,0,0,0,0,0,1,6,6,6,6,6,6,6,6,6,6,6,6,6],
                    [6,6,6,6,6,6,6,6,6,6,6,1,0,0,0,0,0,0,20,21,21,21,21,21,21,21,21,21,22,0,0,0,0,0,0,0,1,6,6,6,6,6,6,6,6,6,6,6,6,6],
                    [6,6,6,6,6,6,6,6,6,6,6,1,0,0,0,0,0,0,0,0,0,0,0,0,0,0,0,0,0,0,0,0,0,0,0,0,1,6,6,6,6,6,6,6,6,6,6,6,6,6],
                    [6,6,6,6,6,6,6,6,6,6,6,1,0,0,0,0,0,0,0,0,0,0,0,0,0,0,0,0,0,0,0,0,0,0,0,0,1,6,6,6,6,6,6,6,6,6,6,6,6,6],
                    [6,6,6,6,6,6,6,6,6,6,6,1,1,1,1,1,1,1,1,1,1,1,1,1,1,1,1,1,1,1,1,1,1,1,1,1,1,6,6,6,6,6,6,6,6,6,6,6,6,6],
                    [1,1,1,1,1,1,1,1,1,1,1,1,1,1,1,1,1,1,1,1,1,1,1,1,1,1,1,1,1,1,1,1,1,1,1,1,1,1,1,1,1,1,1,1,1,1,1,1,1,1],
                    [40,40,40,40,40,40,40,40,40,40,40,40,40,40,40,40,40,40,40,40,40,40,40,40,40,40,40,40,40,40,40,40,40,40,40,40,40,40,40,40,40,40,40,40,40,40,40,40,40,40]
                ]
            }
        ]
    },
    
    "entities": {
        "enemies": [
            {"type": "walqer_bot", "x": 15, "y": 18},
            {"type": "walqer_bot", "x": 35, "y": 18},
            {"type": "jumper_drqne", "x": 22, "y": 5},
            {"type": "jumper_drqne", "x": 28, "y": 9},
            {"type": "qortana_halo", "x": 40, "y": 12},
            {"type": "qlippy", "x": 25, "y": 15},
            {"type": "briq_beaver", "x": 45, "y": 8}
        ],
        
        "collectibles": [
            {"type": "chip_green", "x": 10, "y": 18},
            {"type": "chip_green", "x": 18, "y": 6},
            {"type": "chip_green", "x": 30, "y": 10},
            {"type": "floppy_purple", "x": 25, "y": 3},
            {"type": "floppy_purple", "x": 42, "y": 15},
            {"type": "key_orange", "x": 38, "y": 6}
        ],
        
        "powerups": [
            {"type": "jumpupstiq", "x": 20, "y": 16},
            {"type": "jettpaq", "x": 43, "y": 10}
        ],
        
        "hazards": [
            {"type": "acid_pool", "x": 12, "y": 20, "width": 4},
            {"type": "acid_pool", "x": 32, "y": 20, "width": 3},
            {"type": "spikes", "x": 24, "y": 19, "width": 2}
        ],
        
        "doors": [
            {"x": 47, "y": 18, "requires_key": true, "destination": "level03"}
        ]
    },
    
    "wonqmodes_available": ["low_g", "glitch", "mirror", "junglist"],
    
    "exit": {
        "x": 48,
        "y": 18,
        "next_level": "level03"
    }
}
